1111111111111111111111
10010E000CC00000CC0101
11CC0000P0011100000001
1000C0000001111100CC11
1111111111111111111111
