11111111111111111
11100001110000011
101011CC000000001
1EPCC10000000CC01
11111111111111111