11111111111111111111
10100000C000000Y0001
1000011111C00000C001
100P01E000000Y000001
11111111111111111111