11111111111111111111
10100000C00000001001
1000011111C00001C101
100P01E0000000000001
11111111111111111111