1111111111111111111111
1000000Y0CC00000CC0001
1100E000P0011100011001
1000000Y0001111101CC11
1111111111111111111111