1111111111111111111111
1000Y0000CC00001CC1101
1100E000P0011101111101
100000000001111101CC11
1111111111111111111111